VWWWWWWWWWWWWWWWWWV
VWBBBBBBBWBBBBBBBWV
VWBWWBWWBWBWWBWWBWV
VWBBBBBBBBBBBBBBBWV
VWBWWBBBWWWBBBWWBWV
VWBBBBWBBWBBWBBBBWV
VWWWWBWWBWBWWBWWWWV
VWWWWBWBBBBBWBWWWWV
TBBBBBWBWWWBWBBBBBT
TBBBBBBBWWWBBBBBBBT
VWWWWBWBBPBBWBWWWWV
VWWWWBWBWWWBWBWWWWV
VWBBBBBBBWBBBBBBBWV
VWBWWBWWBWBWWBWWBWV
VWBBWBBBBBBBBBWBBWV
VWWBWBWBWWWBWBWBWWV
VWBBBBWBBWBBBBWBBWV
VWBBBBWBBWBBBBWBBWV
VWBWWWWWBWBWWWWWBWV
VWBBBBBBBBBBBBBBBWV
VWWWWWWWWWWWWWWWWWV
