WWWWWWWWWWWWWWWWW
WBBBBBBBWBBBBBBBW
WBWWBWWBWBWWBWWBW
WBBBBBBBBBBBBBBBW
WBWWBBBWWWBBBWWBW
WBBBBWBBWBBWBBBBW
WWWWBWWBWBWWBWWWW
WWWWBWBBBBBWBWWWW
BBBBBWBWWWBWBBBBB
BBBBBBBWWWBBBBBBB
WWWWBWBBPBBWBWWWW
WWWWBWBWWWBWBWWWW
WBBBBBBBWBBBBBBBW
WBWWBWWBWBWWBWWBW
WBBWBBBBBBBBBWBBW
WWBWBWBWWWBWBWBWW
WBBBBWBBWBBBBWBBW
WBBBBWBBWBBBBWBBW
WBWWWWWBWBWWWWWBW
WBBBBBBBBBBBBBBBW
WWWWWWWWWWWWWWWWW
