VWWWWWWWWWWWWWWWWWV
VWBBBBBBBWBBBBBBBWV
VWBWWBWWBWBWWBWWBWV
VWBBBBBBBBBBBBBBBWV
VWBWWBBBWWWBBBWWBWV
VWBBBBWBBWBBWBBBBWV
VWWWWBWWBWBWWBWWWWV
VWWWWBWV1234WBWWWWV
TBBBBBWBEVEBWBBBBBT
TBBBBBBBEEEBBBBBBBT
VWWWWBWBBPBBWBWWWWV
VWWWWBWBWWWBWBWWWWV
VWBBBBBBBWBBBBBBBWV
VWBWWBWWBWBWWBWWBWV
VWBBWBBBBBBBBBWBBWV
VWWBWBWBWWWBWBWBWWV
VWBBBBWBBWBBBBWBBWV
VWBBBBWBBWBBBBWBBWV
VWBWWWWWBWBWWWWWBWV
VWBBBBBBBBBBBBBBBWV
VWWWWWWWWWWWWWWWWWV
